NO ./src/imgs/redbrick.png
SO ./src/imgs/redbrick.png
WE ./src/imgs/redbrick.png
EA ./src/imgs/redbrick.png

F 110,180,40
C 0,0,30

1111111111
1000000001
1011111101
1000000001
100W000001
1000000001
1011111101
1000000001
1111111111